10 6
##########
#1   @   #
#   ##   #
#   ##   #
#   2    #
##########