9 10
    ####
1   #   #
    #   #
       ##
 ##
#     ##
#       #
####    #
    #  2#
    #####
