12 10
1         #
    #     #
          #
  ####    #
          #
          #
####      #
#   #    2#
###########