10 9
@@@@@@@@@@
 2


@@@@@@@@@@
@#      #@
@#      #@
@#     1#@
@@@@@@@@@@